11111111110111111111
10000WW000000E000001
00000000PP0011100001
10000000000010100001
11110111111111111111