111111111
1C0SCS0E1
110SPS111
1C00000C1
111111111