111111111
1C00C00E1
110SP0111
1C000S0C1
111111111