1111111111111
1S010000000C1
1000011111S01
1P0011E000001
1111111111111