111111111
1C00CS0E1
1100P0111
1CS0000C1
111111111