1111111111111111111111
1C1000101010101C0010C1
10101011101110111S1011
1000000P00000000001001
1011101S11111010111C01
1111101S1C101010001001
1000101010000S10111011
1C101C1011011000101011
1110111010001010111011
1000C00C10E01000000001
1111111111111111111111