1111111111111
10101P10001C1
1000001011101
1011101000C01
1C10000001111
1000111100S01
1010111100111
1S10011C00001
1011011111001
10C10000C10E1
1111111111111